10 5
100 100
8 2 2 2 2 2 2 2 2 2 2 2 2 2 2 2 2 2 2 7
9 0 0 0 0 0 0 0 0 0 0 0 0 0 0 0 0 0 0 9
9 0 0 0 0 0 0 0 0 0 0 0 0 0 0 0 0 0 0 9
9 0 0 8 2 2 7 0 0 0 0 0 0 8 2 2 7 0 0 9
6 2 2 2 2 2 2 2 2 2 2 2 2 2 2 2 2 2 2 5

